1 1 1 1 1 1 1 1 1 1 1 1 1 1 1 1 1 1
1 2 2 2 2 2 1 1 5 5 1 1 1 1 1 1 1 1
1 2 4 4 4 2 1 5 5 5 1 1 1 1 1 1 1 1
1 2 4 4 4 2 1 5 5 1 1 3 3 1 1 1 1 1
1 2 4 4 4 2 1 5 5 1 3 3 3 3 1 1 1 1
1 2 2 2 4 2 1 1 1 1 1 3 3 3 1 1 1 1
1 1 1 1 0 1 1 1 1 1 1 1 1 3 1 1 1 1
1 1 1 1 0 1 1 1 1 1 1 1 1 3 1 1 1 1
1 1 5 1 0 0 0 0 0 1 1 1 1 3 1 1 1 1 
1 1 5 1 1 1 1 1 0 0 1 1 3 3 3 1 1 1
1 1 5 5 5 1 1 1 1 0 1 3 3 3 3 1 1 1
1 5 5 5 5 5 1 1 1 0 1 3 3 3 3 1 1 1
1 1 5 5 5 5 1 1 1 0 1 1 3 3 1 1 1 1
1 1 1 5 5 5 1 1 1 0 0 1 1 1 1 1 1 1
1 1 1 1 1 1 1 1 1 1 0 0 1 1 1 1 1 1
1 1 1 1 1 1 1 1 1 1 1 0 0 1 1 1 1 1