5 5 5 5 5 5 5 1 1 1 1 1 1 5 5 3 3 3 3 3 3 3 3 3 3 3 3 3 3 3
5 2 2 2 2 2 2 2 2 2 2 2 2 5 1 1 3 3 2 2 2 2 2 2 2 2 2 3 3 3
5 2 4 4 4 4 4 4 4 4 4 4 2 1 1 1 1 3 2 4 2 4 4 4 2 4 2 3 3 3
5 2 4 4 4 4 4 4 4 4 2 4 2 1 5 5 1 1 2 4 2 4 4 4 2 4 2 3 3 3
5 2 4 4 4 4 4 4 4 4 2 4 2 1 5 1 0 1 2 4 2 7 4 7 2 4 2 3 3 3
5 2 4 4 4 4 4 4 4 4 2 4 2 1 1 0 1 1 2 4 4 4 4 4 4 4 2 3 3 3
5 2 4 4 4 4 4 4 4 4 2 4 2 1 1 0 1 1 2 4 4 4 4 4 4 4 2 1 3 3
1 2 4 4 4 4 4 4 4 4 2 4 2 2 2 4 2 2 2 4 4 4 4 4 4 4 2 1 3 3
1 2 4 4 4 4 4 4 4 4 2 4 4 4 4 4 4 4 4 4 4 4 4 4 4 4 2 1 3 3
1 2 4 4 4 4 4 4 4 4 2 2 2 2 2 2 2 2 2 4 4 4 4 4 4 4 2 5 3 3
1 2 4 4 4 4 4 4 4 4 2 1 1 1 1 1 1 1 2 4 4 4 4 4 4 4 2 5 3 3
1 2 4 4 4 4 4 4 4 4 2 1 5 5 5 1 1 1 2 2 2 2 4 2 2 2 2 5 3 3
1 2 4 4 4 4 4 4 4 4 2 1 1 5 5 1 1 1 1 1 1 2 4 2 1 5 5 5 3 3
1 2 2 2 2 2 4 2 2 2 2 1 1 5 1 1 1 5 1 1 1 0 0 1 1 1 1 1 3 3
1 1 1 1 1 2 4 2 5 5 1 1 1 1 1 1 1 5 5 5 1 1 0 1 1 1 1 3 3 3
1 5 5 1 1 2 4 2 5 5 1 1 1 1 1 1 1 1 0 0 1 1 1 1 1 1 1 3 3 3
1 5 5 5 1 2 4 2 5 1 1 1 5 5 5 1 1 1 1 1 1 1 0 1 1 1 1 3 3 3
5 5 5 1 2 2 4 2 2 2 2 1 5 5 5 1 1 1 1 5 5 1 1 1 1 1 5 1 1 3
1 1 1 1 2 4 4 4 4 4 2 1 1 1 1 1 1 1 5 5 5 1 1 1 1 1 5 1 1 3
1 2 2 2 2 4 4 4 4 4 2 2 1 1 1 1 1 0 1 1 1 1 1 1 1 5 5 1 1 3
1 2 4 4 4 4 4 4 4 4 4 4 0 1 0 0 0 1 0 1 1 1 1 1 5 5 1 1 1 3
1 2 2 2 2 4 4 4 4 4 2 2 5 5 1 0 1 5 1 1 1 1 1 1 1 1 1 5 1 3
1 5 5 5 2 4 4 4 4 4 2 5 5 1 1 1 1 1 1 1 1 1 1 5 1 1 1 1 3 3
3 1 1 1 2 2 2 2 2 2 2 1 1 1 1 1 1 3 3 3 1 1 3 3 5 5 5 1 3 3
3 3 3 1 1 1 1 1 1 1 1 1 1 3 3 3 3 3 3 3 3 3 3 3 3 3 3 3 3 3
3 3 3 3 3 3 3 3 3 3 3 3 3 3 3 3 3 3 3 3 3 3 3 3 3 3 3 3 3 3
3 3 3 3 3 3 3 3 3 3 3 3 3 3 3 3 3 3 3 3 3 3 3 3 3 3 3 3 3 3
3 3 3 3 3 3 3 3 3 3 3 3 3 3 3 3 3 3 3 3 3 3 3 3 3 3 3 3 3 3
3 3 3 3 3 3 3 3 3 3 3 3 3 3 3 3 3 3 3 3 3 3 3 3 3 3 3 3 3 3
3 3 3 3 3 3 3 3 3 3 3 3 3 3 3 3 3 3 3 3 3 3 3 3 3 3 3 3 3 3